##########
#P  #   E#
# ## #  ##
#    ##  #
# ##   # #
#  ##  # #
##  #### #
#        #
# ###### #
##########